0000000000000000
1101110111111110
0101010100000010
0101010101111010
0101010101001010
0101011101001010
0111000001001110
000000p022200000
0000000022200000